7 9 1 4
 ####### 
##     ##
# .     #
#   #   #
#     B #
##     ##
 ####### 