5 6 1 1
######
#    #
#  B.#
# .B #
######