8 9 4 4
   ####  
####  ## 
#    B # 
#  # #.##
##B. .  #
 #  #B  #
 ##   ###
  #####  
