8 7 6 4
#######
#..B..#
#..#..#
# BBB #
#  B  #
# BBB #
#  #  #
#######
300
