10 6 6 1
##### 
#   # 
# # ##
#    #
##B  #
# X ##
# X  #
# X# #
# .  #
######
300
