8 8 5 4
 #####  
 #   ## 
 # #  ##
 #  B  #
## #X  #
# .# B #
#  . ###
######  
300
