10 10 1 4
##########
#..#  B .#
# B. B B.#
#B #B##.##
# B#..B  #
#  B..#B #
##.##B# B#
#.B B .B #
#. B  #..#
##########
