7 9 2 3
 ########
 #  ## .#
##  #   #
#. B#B  #
#  B   ##
#. ##  # 
######## 
300
