17 19 14 4
###################
#  #    #  #  #   #
#  #B#        # # #
#      # # #    # #
## #####     #    #
 #    #   # #  #  #
 #      #   #    ##
## # #   #    #.  #
#    # # # #   #  #
# ##     #        #
#    #     #### ###
#  #### ####  # ###
##       #    #   #
## #####    #     #
#         #    # ##
#   ####  ####   # 
#####  ####  ##### 
