17 19 14 1
####   ####   #####
#  #####  #####   #
#  #   #          #
#      #  ### #####
## ## ### ### #   #
#  .#      #      #
# ##  ##   #  # ###
# ##    ####  #   #
#  ##   #  ####   #
## ######  #   # ##
#  #   ##  #      #
# ##      #### #  #
#   # ### #    #  #
###B#  ## #  #  ###
#      #     #  #  
#   #  #     #  #  
#################  
1200
