6 12 1 3
 ########## 
##   #    ##
# B ....B  #
#  B#### B #
#   #  #  ##
#####  #### 
