6 7 1 1
###### 
#    ##
# BB  #
# #. .#
#     #
#######