7 7 2 1
  #### 
###  # 
#  .B##
#   B #
# #.  #
#     #
#######