7 7 1 3
 ##### 
##   ##
#  #  #
# BXB #
#  .  #
## . ##
 ##### 