6 8 1 1
######  
#    ###
#   .. #
# BBB  #
#  # . #
########