6 10 2 3
 #########
##   X   #
#   X#B. #
# #  X  ##
#   ##  # 
######### 
