9 8 2 2
  ##### 
###   # 
#. B  # 
### B.# 
#.##B # 
# # . ##
#B XBB.#
#   .  #
########
300
