14 18 7 8
##################
#   #  #   #   # #
# #      #   #   #
#    #      #  # #
## #  # #       ##
#   #     # #    #
#  #   # #   # # #
##   #   B #     #
#  #    # #  # . #
#    # #      # ##
## #      # #    #
#     #  #       #
#    #     #  #  #
##################
600
