9 10 6 3
##########
#      ..#
#  #  B..#
## ##B#  #
 #     B #
 # # #####
 #   B #  
 #     #  
 #######  
300
